0,0,0,0,0,0,0,1,0,0,0,0,0,0,0
0,1,1,5,1,1,1,1,1,1,1,1,1,1,0
0,1,1,2,1,1,5,1,1,1,2,1,2,1,0
0,1,2,2,1,1,2,2,2,1,2,2,2,1,0
0,1,2,1,1,1,1,1,1,1,1,1,2,1,0
0,1,1,1,1,2,2,1,2,2,1,5,1,1,0
0,1,1,2,1,2,1,1,1,2,1,2,1,1,0
1,5,1,2,1,5,1,3,1,1,1,2,1,1,1
0,1,1,2,1,2,1,1,1,2,1,2,1,5,0
0,1,1,1,1,2,2,1,2,2,1,1,1,1,0
0,1,2,1,1,1,1,1,5,1,1,1,2,1,0
0,1,2,2,2,1,2,2,2,1,1,2,2,1,0
0,1,2,1,2,1,1,1,1,1,1,2,1,1,0
0,1,1,1,1,1,1,1,1,5,1,1,1,1,0
0,0,0,0,0,0,0,1,0,0,0,0,0,0,0
,,,,,,,,,,,,,,
0,0,0,0,0,0,0,1,0,0,0,0,0,0,0
0,80,1,1,2,1,2,1,2,1,2,1,1,83,0
0,1,2,1,1,1,1,1,1,1,1,1,2,1,0
0,1,1,2,2,2,1,2,2,2,2,2,1,1,0
0,2,1,2,1,1,1,1,1,1,1,2,1,2,0
0,1,1,2,1,2,1,2,1,2,1,2,1,1,0
0,2,1,2,1,1,1,1,1,1,1,1,1,2,0
1,1,1,2,1,2,1,3,1,2,1,2,1,1,1
0,2,1,1,1,1,1,1,1,1,1,2,1,2,0
0,1,1,2,1,2,1,2,1,2,1,2,1,1,0
0,2,1,2,1,1,1,1,1,1,82,2,1,2,0
0,1,1,2,2,2,2,2,1,2,2,2,1,1,0
0,1,2,1,1,1,1,1,1,1,1,1,2,1,0
0,81,1,1,2,1,2,1,2,1,2,1,1,82,0
0,0,0,0,0,0,0,1,0,0,0,0,0,0,0
,,,,,,,,,,,,,,
0,0,0,0,0,0,0,1,0,0,0,0,0,0,0
0,1,1,1,1,1,1,1,1,1,1,1,1,1,0
0,1,2,1,1,2,1,1,1,2,1,2,1,1,0
0,1,1,2,1,1,2,4,2,1,1,2,2,1,0
0,1,1,1,2,1,1,1,1,1,2,1,1,1,0
0,1,2,1,1,1,2,1,2,2,1,1,2,1,0
0,1,1,2,1,2,1,1,1,2,1,2,1,1,0
1,1,1,4,1,1,1,3,1,1,1,4,1,1,1
0,1,1,2,1,2,1,1,1,2,1,2,1,1,0
0,1,2,1,1,1,2,1,2,1,1,1,2,1,0
0,1,1,1,2,1,1,1,1,1,2,1,1,1,0
0,1,1,2,1,1,2,4,2,1,1,2,1,1,0
0,1,2,1,1,2,1,1,1,2,1,1,2,1,0
0,1,1,1,1,1,1,1,1,1,1,1,1,1,0
0,0,0,0,0,0,0,1,0,0,0,0,0,0,0
,,,,,,,,,,,,,,
0,0,0,0,0,0,0,1,0,0,0,0,0,0,0
0,1,1,1,1,1,1,1,1,1,1,1,1,1,0
0,1,1,2,1,2,1,1,1,2,1,1,1,1,0
0,1,2,2,2,2,2,2,2,2,1,2,2,1,0
0,1,1,2,1,1,1,1,1,1,1,2,1,1,0
0,1,2,2,1,2,2,1,1,2,1,2,1,1,0
0,1,1,2,1,2,1,1,1,2,1,2,1,1,0
1,1,1,2,1,1,1,3,1,2,1,2,2,1,1
0,1,1,2,1,1,1,1,1,2,1,1,1,1,0
0,1,2,2,1,2,2,2,2,2,1,2,2,1,0
0,1,1,1,1,1,1,1,1,1,1,2,1,1,0
0,1,1,2,2,2,2,2,1,2,2,2,2,1,0
0,1,1,2,1,1,1,2,1,2,1,2,1,1,0
0,1,1,1,1,1,1,1,1,1,1,1,1,1,0
0,0,0,0,0,0,0,1,0,0,0,0,0,0,0
,,,,,,,,,,,,,,
0,0,0,0,0,0,0,1,0,0,0,0,0,0,0
0,1,1,1,1,1,1,1,1,1,1,7,7,7,0
0,7,2,2,1,2,2,2,2,2,1,1,2,7,0
0,7,7,1,1,1,1,1,1,1,1,1,2,1,0
0,1,1,1,1,1,1,1,1,1,1,1,1,1,0
0,1,2,1,1,2,1,2,2,2,1,1,2,1,0
0,1,2,1,1,2,1,1,1,1,1,1,2,1,0
1,1,2,1,1,2,1,3,1,2,1,7,2,1,1
0,1,2,1,1,1,1,1,1,2,1,1,2,1,0
0,1,2,7,1,2,2,2,1,2,7,1,2,1,0
0,1,7,7,7,1,1,1,1,7,7,1,1,1,0
0,1,2,7,7,7,1,1,1,1,1,1,7,1,0
0,1,2,7,7,2,2,2,2,2,1,2,2,1,0
0,1,1,1,1,1,1,1,1,1,1,1,1,1,0
0,0,0,0,0,0,0,1,0,0,0,0,0,0,0