0, 0, 0, 0, 0, 0, 0, 1, 0, 0, 0, 0, 0, 0, 0
0, 1, 2, 3, 4, 1,60, 1, 7,82, 1, 1, 1, 1, 0
0, 1, 1, 1, 7, 7, 7, 1, 1, 1, 1, 1, 1, 1, 0
0, 1, 2, 1, 2, 1, 1, 1, 1, 1,80, 1, 1, 1, 0
0, 1, 1, 1,83, 1, 7, 1, 1, 1, 1, 1, 1, 1, 0
0, 1, 2, 1, 2, 1, 1, 1, 1, 1, 1, 1, 1, 1, 0
0, 1, 1, 1, 1, 1, 1, 1, 1, 1, 1, 1, 1, 1, 0
1, 5, 1, 1, 5, 1, 1, 3, 1,60, 1, 1, 1, 1, 1
0, 1, 2, 1, 1, 1, 1, 1, 1, 1, 1, 1, 1, 1, 0
0, 1, 2, 1, 2, 1, 5, 1, 1, 1, 1, 1,80, 1, 0
0, 1, 2, 2, 2, 2, 1, 1, 1, 1, 1, 1, 1, 1, 0
0, 1, 2, 1, 1, 1, 1, 1, 2, 4, 2, 2, 4, 2, 0
0, 1, 2, 2, 2, 2, 2, 4, 2, 4, 2, 1, 1, 1, 0
0, 1, 1, 1, 1, 1, 1, 1, 1, 4, 1, 1, 1, 4, 0
0, 0, 0, 0, 0, 0, 0, 1, 0, 0, 0, 0, 0, 0, 0
, , , , , , , , , , , , , , 
