0, 0, 0, 0, 0, 0, 0, 1, 0, 0, 0, 0, 0, 0, 0
0, 1, 2, 3, 4, 5,60, 1, 7,82, 1, 1, 1, 1, 0
0,60, 1, 1, 7, 7, 7, 1, 1, 1, 1, 1, 1, 1, 0
0,61, 2, 1, 2, 1, 1, 1, 1, 1,80, 1, 1, 1, 0
0,62, 1, 1,83, 1, 7, 1, 1, 1, 1, 1, 5, 1, 0
0,63, 2, 1, 2, 1, 1, 1, 1, 1, 1, 1, 1, 1, 0
0, 1, 1, 1, 1, 1, 1, 1, 1, 1, 1, 1, 1, 1, 0
1, 1, 1, 1, 1, 1, 1, 3, 1, 1, 1, 1, 1, 1, 1
0, 5, 2, 1, 1, 1, 1, 1, 1, 1, 1, 1, 1, 1, 0
0, 5, 2, 3, 2, 1, 1, 61, 1, 1, 1, 1,80, 1, 0
0, 1, 2, 2, 2, 2, 1, 1, 1, 1, 1, 1, 1, 1, 0
0, 1, 2, 1, 1, 1, 1, 1, 2, 4, 2, 2, 4, 2, 0
0, 1, 2, 2, 2, 2, 2, 4, 2, 4, 2, 1, 1, 1, 0
0, 1, 1, 1, 1, 1, 1, 1, 1, 4, 1, 1, 1, 4, 0
0, 0, 0, 0, 0, 0, 0, 1, 0, 0, 0, 0, 0, 0, 0
, , , , , , , , , , , , , , 
