0,0,0,0,0,0,0,1,0,0,0,0,0,0,0
0,1,1,1,83,1,7,1,2,1,2,6,2,1,0
0,1,1,82,7,7,7,1,6,1,6,1,1,1,0
0,1,1,1,7,7,1,1,1,1,1,1,1,1,0
0,1,1,1,1,7,7,1,1,1,1,1,5,1,0
0,81,1,1,1,1,1,1,1,1,1,1,1,1,0
0,80,1,1,1,1,1,1,1,1,1,1,5,1,0
1,1,1,1,1,1,1,3,1,1,1,1,1,1,1
0,1,1,1,2,1,1,1,1,1,1,1,5,1,0
0,1,1,1,2,1,1,1,1,1,1,1,1,1,0
0,1,2,2,2,1,1,1,1,1,1,1,1,1,0
0,1,2,1,1,1,1,1,2,4,2,1,1,1,0
0,1,2,2,2,2,2,4,2,4,2,1,1,1,0
0,1,1,1,1,1,1,1,1,4,1,1,1,4,0
0,0,0,0,0,0,0,1,0,0,0,0,0,0,0
,,,,,,,,,,,,,,
